[Stage 1]
Plus
5
00100
00100
11111
00100
00100
[End]




[Stage 2]
Square
5
11111
10001
10001
10001
11111
[End]



[Stage 3]
Letter T
5
11111
00100
00100
00100
00100
[End]




[Stage 4]
Letter E
5
11111
10000
11100
10000
11111
[End]


[Stage 5]
Smiley
10
0000000000
0001001000
0001001000
0001001000
0000000000
0100000010
0010000100
0001111000
0000000000
0000000000
[End]

[Stage 6]
Mario
10
0011111110
0011111111
1111111111
0010100111
1110100111
1000000001
1111000001
0111100011
0010000110
0001111100
[End]


[Stage 7]
Gameboy
15
111111111111111
110000000000011
110111111111011
110110000011011
110110000011011
110110000011011
110110000011011
110111111111011
110000000000011
110010000000011
110111000000011
110010000111011
110000000000011
110000000000111
111111111111111
[End]

[Stage 8]
Star
15
111111100110001
111111001100011
111111011000111
111110111011110
111110111111100
111100011111001
111100011111011
000000000001110
100010100011100
110010100111000
111000001110011
110000000110111
110001000111111
100011100011111
101111111011111
[End]

[Stage 9]
Letter P
5
11111
10001
11111
10000
10000
[End]

[Stage 10]
Letter J
5
11111
00100
00100
00100
11100
[End]

[Stage 11]
Letter O
5
01110
11001
11001
11001
01110
[End]

[Stage 12]
Dollar Sign
10
0001001000
0111111111
1111111111
1101001000
1111111110
0111111111
0001001011
1111111111
1111111111
0001001000
[End]

[Stage 13]
Boo
10
1100000111
1000000011
0000000001
0101000001
0101001101
0000000100
0111001100
0010000000
1000000001
1110000111
[End]

[Stage 14]
Bullet Bill
15
000000000000000
000011111111011
001110100001100
001010111111111
011100111111111
110000111001101
111001111001101
111111001001101
111110000001101
111110000011101
011111001111111
011111111111111
001111111111111
000011111111011
000000000000000
[End]

[Stage 15]
Baby Yoshi
15
000000111100000
000001111110000
011101111111000
111110101111000
110110101111100
111110001111100
111111111111100
111111111011000
011111100111000
001100011111111
000100011111111
001000011111111
001000110000111
000100100000111
000011111111110
[End]

[Stage 16]
Cheep-Cheep
15
000000011110000
011111010011000
110101110001100
100000111100100
101010100110100
100000100001111
110100100001101
111111000000101
100011001110101
100001010010110
011001000010101
111001001100101
100011000001101
111111000011011
000001111110000
[End]

[Stage 17]
Poochy
15
000000000000111
000100100000101
000111111000111
001100101110010
010100100111010
011110000010110
100011100011110
100000110111110
111100011101011
011111001111011
011110010100001
010000111110001
001111110000101
000101110111101
000111011100111
[End]

[Stage 18]
Yoshi Egg
15
000001111100000
000011001110000
000111100111000
001111100111100
011111000011110
011110000001110
111100011100011
111000111110001
100001111111001
100000111110001
111000011100111
111110000001110
011111000011110
001111000111100
000011111110000
[End]

[Stage 19]
Meowth
15
011111101010010
011101110111111
011000111110111
011001110011110
011011000011110
011100000001100
101001111000000
101010010100001
110100010010010
010110010110011
010001111000000
111000000000000
101001100111111
100100111100001
000011010000000
[End]

[Stage 20]
Psyduck
15
000000111100000
000011000011000
000100000001100
001110000111110
010101001010110
110001001000111
011110110111110
110011001101100
011100000011110
101001010011100
011000000110110
010000000011010
010000000011010
011000000011011
101100000110001
[End]